type octile
height 7
width 7
map
@.@..@.
.....@.
.@...@.
..@@...
@@@@@.@
...@@@@
.@..@..
