type octile
height 33
width 46
map
..............................................
.pp.pp.tttttttttt.tttttttttt.tttttttttt.pp.pp.
.pp.pp.@@@@@@@@@@.@@@@@@@@@@.@@@@@@@@@@.pp.pp.
.pp.pp.tttttttttt.tttttttttt.tttttttttt.pp.pp.
.pp.pp..................................pp.pp.
.pp.pp.tttttttttt.tttttttttt.tttttttttt.pp.pp.
.pp.pp.@@@@@@@@@@.@@@@@@@@@@.@@@@@@@@@@.pp.pp.
.pp.pp.tttttttttt.tttttttttt.tttttttttt.pp.pp.
.pp.pp..................................pp.pp.
.pp.pp.tttttttttt.tttttttttt.tttttttttt.pp.pp.
.pp.pp.@@@@@@@@@@.@@@@@@@@@@.@@@@@@@@@@.pp.pp.
.pp.pp.tttttttttt.tttttttttt.tttttttttt.pp.pp.
.pp.pp..................................pp.pp.
.pp.pp.tttttttttt.tttttttttt.tttttttttt.pp.pp.
.pp.pp.@@@@@@@@@@.@@@@@@@@@@.@@@@@@@@@@.pp.pp.
.pp.pp.tttttttttt.tttttttttt.tttttttttt.pp.pp.
.pp.pp..................................pp.pp.
.pp.pp.tttttttttt.tttttttttt.tttttttttt.pp.pp.
.pp.pp.@@@@@@@@@@.@@@@@@@@@@.@@@@@@@@@@.pp.pp.
.pp.pp.tttttttttt.tttttttttt.tttttttttt.pp.pp.
.pp.pp..................................pp.pp.
.pp.pp.tttttttttt.tttttttttt.tttttttttt.pp.pp.
.pp.pp.@@@@@@@@@@.@@@@@@@@@@.@@@@@@@@@@.pp.pp.
.pp.pp.tttttttttt.tttttttttt.tttttttttt.pp.pp.
.pp.pp..................................pp.pp.
.pp.pp.tttttttttt.tttttttttt.tttttttttt.pp.pp.
.pp.pp.@@@@@@@@@@.@@@@@@@@@@.@@@@@@@@@@.pp.pp.
.pp.pp.tttttttttt.tttttttttt.tttttttttt.pp.pp.
.pp.pp..................................pp.pp.
.pp.pp.tttttttttt.tttttttttt.tttttttttt.pp.pp.
.pp.pp.@@@@@@@@@@.@@@@@@@@@@.@@@@@@@@@@.pp.pp.
.pp.pp.tttttttttt.tttttttttt.tttttttttt.pp.pp.
..............................................
