type octile
height 33
width 46
map
..............................................
..............................................
.......@@@@@@@@@@.@@@@@@@@@@.@@@@@@@@@@.......
..............................................
..............................................
..............................................
.......@@@@@@@@@@.@@@@@@@@@@.@@@@@@@@@@.......
..............................................
..............................................
..............................................
.......@@@@@@@@@@.@@@@@@@@@@.@@@@@@@@@@.......
..............................................
..............................................
..............................................
.......@@@@@@@@@@.@@@@@@@@@@.@@@@@@@@@@.......
..............................................
..............................................
..............................................
.......@@@@@@@@@@.@@@@@@@@@@.@@@@@@@@@@.......
..............................................
..............................................
..............................................
.......@@@@@@@@@@.@@@@@@@@@@.@@@@@@@@@@.......
..............................................
..............................................
..............................................
.......@@@@@@@@@@.@@@@@@@@@@.@@@@@@@@@@.......
..............................................
..............................................
..............................................
.......@@@@@@@@@@.@@@@@@@@@@.@@@@@@@@@@.......
..............................................
..............................................
