type octile
height 21
width 35
map
...................................
.pp.pp.tttttttttt.tttttttttt.pp.pp.
.pp.pp.@@@@@@@@@@.@@@@@@@@@@.pp.pp.
.pp.pp.tttttttttt.tttttttttt.pp.pp.
.pp.pp.......................pp.pp.
.pp.pp.tttttttttt.tttttttttt.pp.pp.
.pp.pp.@@@@@@@@@@.@@@@@@@@@@.pp.pp.
.pp.pp.tttttttttt.tttttttttt.pp.pp.
.pp.pp.......................pp.pp.
.pp.pp.tttttttttt.tttttttttt.pp.pp.
.pp.pp.@@@@@@@@@@.@@@@@@@@@@.pp.pp.
.pp.pp.tttttttttt.tttttttttt.pp.pp.
.pp.pp.......................pp.pp.
.pp.pp.tttttttttt.tttttttttt.pp.pp.
.pp.pp.@@@@@@@@@@.@@@@@@@@@@.pp.pp.
.pp.pp.tttttttttt.tttttttttt.pp.pp.
.pp.pp.......................pp.pp.
.pp.pp.tttttttttt.tttttttttt.pp.pp.
.pp.pp.@@@@@@@@@@.@@@@@@@@@@.pp.pp.
.pp.pp.tttttttttt.tttttttttt.pp.pp.
...................................
