type octile
height 21
width 35
map
...................................
...................................
.......@@@@@@@@@@.@@@@@@@@@@.......
...................................
...................................
...................................
.......@@@@@@@@@@.@@@@@@@@@@.......
...................................
...................................
...................................
.......@@@@@@@@@@.@@@@@@@@@@.......
...................................
...................................
...................................
.......@@@@@@@@@@.@@@@@@@@@@.......
...................................
...................................
...................................
.......@@@@@@@@@@.@@@@@@@@@@.......
...................................
...................................
