type octile
height 33
width 46
map
..............................................
.......tttttttttt.tttttttttt.tttttttttt.......
.......@@@@@@@@@@.@@@@@@@@@@.@@@@@@@@@@.......
.......tttttttttt.tttttttttt.tttttttttt.......
..............................................
.......tttttttttt.tttttttttt.tttttttttt.......
.......@@@@@@@@@@.@@@@@@@@@@.@@@@@@@@@@.......
.......tttttttttt.tttttttttt.tttttttttt.......
..............................................
.......tttttttttt.tttttttttt.tttttttttt.......
.......@@@@@@@@@@.@@@@@@@@@@.@@@@@@@@@@.......
.......tttttttttt.tttttttttt.tttttttttt.......
..............................................
.......tttttttttt.tttttttttt.tttttttttt.......
.......@@@@@@@@@@.@@@@@@@@@@.@@@@@@@@@@.......
.......tttttttttt.tttttttttt.tttttttttt.......
..............................................
.......tttttttttt.tttttttttt.tttttttttt.......
.......@@@@@@@@@@.@@@@@@@@@@.@@@@@@@@@@.......
.......tttttttttt.tttttttttt.tttttttttt.......
..............................................
.......tttttttttt.tttttttttt.tttttttttt.......
.......@@@@@@@@@@.@@@@@@@@@@.@@@@@@@@@@.......
.......tttttttttt.tttttttttt.tttttttttt.......
..............................................
.......tttttttttt.tttttttttt.tttttttttt.......
.......@@@@@@@@@@.@@@@@@@@@@.@@@@@@@@@@.......
.......tttttttttt.tttttttttt.tttttttttt.......
..............................................
.......tttttttttt.tttttttttt.tttttttttt.......
.......@@@@@@@@@@.@@@@@@@@@@.@@@@@@@@@@.......
.......tttttttttt.tttttttttt.tttttttttt.......
..............................................
