type octile
height 21
width 35
map
...................................
.......tttttttttt.tttttttttt.......
.......@@@@@@@@@@.@@@@@@@@@@.......
.......tttttttttt.tttttttttt.......
...................................
.......tttttttttt.tttttttttt.......
.......@@@@@@@@@@.@@@@@@@@@@.......
.......tttttttttt.tttttttttt.......
...................................
.......tttttttttt.tttttttttt.......
.......@@@@@@@@@@.@@@@@@@@@@.......
.......tttttttttt.tttttttttt.......
...................................
.......tttttttttt.tttttttttt.......
.......@@@@@@@@@@.@@@@@@@@@@.......
.......tttttttttt.tttttttttt.......
...................................
.......tttttttttt.tttttttttt.......
.......@@@@@@@@@@.@@@@@@@@@@.......
.......tttttttttt.tttttttttt.......
...................................
